
הרשמה
התחברות

הרשמה
התחברות
אזורי זמן במערכת
אזור התעשיה - הגדרות המערכת   1  1  178
  
Eeliyahu ניהול  לפני 11 חודשים
ב"ה

מצ"ב טבלה עם אזורי הזמן שניתן להגדיר במערכת

ישראל - IL
אזור	הגדרה
ירושלים	IL/Jerusalem
אלעד	IL/Elad
אילת	IL/Eilat
איתמר	IL/Itamar
אפרת	IL/Efrat
אריאל	IL/Ariel
אשדוד	IL/Ashdod
אשקלון	IL/Ashkelon
באר שבע	IL/Beer_Sheva
בית שמש	IL/Beit_Shemesh
ביתר עילית	IL/Beitar_Ilit
בני ברק	IL/Bney_Brak
דימונה	IL/Dimona
חברון	IL/Hebron
חדרה	IL/Hadera
חיפה	IL/Haifa
טבריה	IL/Tiberias
כרמיאל	IL/Carmiel
מודיעין עילית	IL/Modiin_Ilit
מצפה רמון	IL/Mitzpeh_Ramon
נהריה	IL/Nahariya
נצרת עילית	IL/Natzrat_Ilit
נתניה	IL/Netanya
עכו	IL/Acre
עמנואל	IL/Imanuel
עפולה	IL/Afula
ערד	IL/Arad
צפת	IL/Tzfat
קדומים	IL/Kdumim
קרית גת	IL/Kiryat_Gat
קרית שמונה	IL/Kiryat_Shmona
רחובות	IL/Rechovot
שדרות	IL/Sderot
תל אביב	IL/Tel_Aviv
קנדה - CA
אזור	הגדרה
מונטריאול	CA/Montreal
טורונטו	CA/Toronto
ארצות הברית - US
מדינה	אזור	הגדרה
וושינגטון די סי	US/DC/Washington
קליפורניה	לוס אנג'לס	US/CA/Los_Angeles
אילינוי	שיקגו	US/IL/Chicago
ניו יורק	ניו יורק	US/NY/New_York
ארגנטינה - AR
אזור	הגדרה
בואנוס איירס	AR/Buenos_Aires
רוסיה - RU
אזור	הגדרה
מוסקבה	RU/Moscow
רוסטוב	RU/RostovDon
אוקראינה - UA
אזור	הגדרה
קייב	UA/Kiev
ניקולייב	UA/Nikolaev
אומן	UA/Uman
פולין - PL
אזור	הגדרה
וורשה	PL/Warsaw
צ'כיה - CZ
אזור	הגדרה
פראג	CZ/Prague
אוסטריה - AT
אזור	הגדרה
וינה	AT/Wien
גרמניה - DE
אזור	הגדרה
ברלין	DE/Berlin
שוויץ - CH
אזור	הגדרה
ציריך	CH/Zurich
צרפת - FR
אזור	הגדרה
פריז	FR/Paris
ספרד - ES
אזור	הגדרה
מדריד	ES/Madrid
ברצלונה	ES/Barcelona
בריטניה - UK
אזור	הגדרה
לונדון	UK/London
מנצ'סטר	UK/Manchester
אוסטרליה - AU
אזור	הגדרה
סידני	AU/Sydney
 4 
 1 מתוך 1 

